C,0,0,0,0,0,C,W,0,0,0,0,0,0,0,0
C,0,0,0,0,0,C,W,0,0,0,0,W,W,W,W
W,W,W,Q,W,W,W,W,W,W,0,0,W,0,0,0
0,0,0,0,0,W,0,0,0,W,0,B,B,0,0,S
0,0,0,0,0,P,0,K,0,Q,0,0,W,0,0,0
0,0,0,0,0,W,0,0,0,W,0,0,W,W,W,W
W,W,W,B,T,W,W,W,W,W,0,0,0,0,0,0
0,0,0,0,0,W,0,W,0,0,0,0,0,0,0,0
0,0,0,0,0,0,0,W,0,0,0,W,W,W,W,W
W,W,W,0,0,0,0,B,0,0,0,W,0,0,0,0
0,0,0,W,W,B,W,W,0,0,0,D,0,0,F,0
0,0,0,B,0,0,0,W,0,0,0,W,0,0,0,0
0,0,0,W,0,0,0,W,0,0,0,W,W,W,W,W
0,0,0,W,0,0,0,W,0,0,0,0,0,0,0,0
